322222222222222222223
200000000000000000002
200000000000000000002
200000000000000000002
200000000000000000002
200000000500500000002
200000000000000000002
200000000000000500002
200000000000000000002
200000000111000000002
200040000000000005002
200000000000000000002
200000040000000000002
200000000000050000002
200000000000000000002
200000000000000000002
200000000000000000002
200000000000000000002
200000000000000000002
200000000000000000002
322222222222222222223