322222222222222222223
200000000000000000002
200000000000000000002
200000000000000000002
200000000000000000002
200000000000000000002
200000000000000000002
200000000000000000002
200000000000000000002
200000000010000000002
200000000000000000002
200000000000000000002
200000000000000000002
200000000000000000002
200000000000000000002
200000000000000000002
200000000000000000002
200000000000000000002
200000000000000000002
200000000000000000002
322222222222222222223