322222222222222222223
200000000000000000002
200000000000000000002
200000000000000000002
200000000000000000002
200000000000000000002
200000000000000000002
200000000000000000002
200000000000000000002
200000000111000000002
200000000000000000002
200000000000000000002
200000000000000000002
200000000000000000002
200000000000000000002
200000000000000000002
200000000000000000002
200000000000000000002
200000000000000000002
200000000000000000002
322222222222222222223
500
20
5
1