322222222222222222223
200000000000000000002
200000000000000000002
200000000022222222002
200222000020000002002
200002222220000002002
200000000020000002002
200000000020000002002
200000000020000002002
200000000111000002002
200000000000000002002
200002000000000002002
200002000002222222002
200002000000002000002
200002000000002000002
200002000000002000002
200002000000002000002
200002000000000000002
200002000000000000002
200002000000000000002
322223222222222222223
400
15
10
2