422222222222222222224
200000000000000000002
200000000000000000002
200000000033333000002
200000000030000000002
200000000030000000002
200000000030000000002
200000000030000000002
200000000000000000002
200000000111000000002
200000000000000000002
200000000000000000002
200000000000000000002
200000000000000000002
200000000000000000002
200000000000000000002
200000000000000000002
200000000000000000002
200000000000000000002
200000000000000000002
422222222222222222224
