322222222222222222223
200000000000000000002
200000000000200000002
200000000022222000002
200000000020000000002
200000000020000000002
200000000020000000002
200000000020000000002
200000000022200000002
200000000111200000002
200000000000200000002
200020222220200000002
200020000000200000002
200022222222200000002
200000000000200000002
200000000000200000002
200000000000200000002
200000000000200000002
200000000000000000002
200000000000000000002
322222222222222222223
