322222222232222222223
200000000020000000002
200000000020000000002
200000000202000000002
200000002000200000002
200000020000020000002
200000200000002000002
200002000000000200002
200020000000000020002
200200000111000002002
200000000000000000002
200200000000000002002
200020000000000020002
200002000000000200002
200000200000002000002
200000020000020000002
200000002000200000002
200000000202000000002
200000000020000000002
200000000020000000002
322222222232222222223
300
30
10
3