322232223222322232223
200020002000200000002
200000002000000000002
200020002000200000002
300032023202320232023
200020002000200000002
200000000000000000002
200020002000200000002
322232223000322230003
200020000000000020002
200000000111000000002
200020000000000020002
300032223000320232023
200020002000200020002
200020000000200000002
200020002000200020002
320232223222320232023
200020002000200020002
200000000000000020002
200020002000200020002
322232223222322232223
350
30
5
2