222222222222222222222
200000000000000000002
200000000000000002002
302222222220222222223
202020002320200000002
202020002320200000002
202020222220200000002
202020000000200000002
202022222220200000002
202000020111000000002
202000020000000000002
202000022202222222223
202000000200000000002
200000000000000000002
200000000000000000002
200000000000000000002
200000000000000000002
200000000000000000002
200000000000000000002
200000000000000000002
222222222222222222222
