333333333333333333333
300000000000000000003
300000000000000002003
302222222220000002203
302000000000000000003
302000000000000000003
302666666660000000003
302666666660000000003
302666666660000000003
302000000111000000003
302000000000000000003
302000000000000000003
302000000000000000003
300000000000000000003
300000000000000000003
300000000000000000003
300000000000000000003
300000000000000000003
300000000000000000003
300000000000000000003
333333333333333333333
