322222222222222222223
200000000000000000002
200000000000300000002
200000000033333000002
200000333030000000002
200000300030000000002
200000333030000000002
200000003030000000002
200033333033300000002
200030300111300000002
200030000000300000002
200030333330300000002
200030000000300000002
200033333333300000002
200000000000300000002
200000000000300000002
200000000000300000002
200000000000300000002
200000000000000000002
200000000000000000002
322222222222222222223
